R 300 400

NO ./path_to_the_north_texture
SO ./path_to_the_south_texture
WE ./path_to_the_west_texture
EA ./path_to_the_east_texture
S ./path_to_the_sprite_texture

F 220,100,0
C 225,30,0

11111111111111111111
10000000000000000001
10000000000000000001
10000000000W00000001
10000000000000000001
10000000000000000001
11111111111111111111