R 600 800
NO ./pics/w2.xpm

EA ./pics/w1.xpm

S ./pics/spr.xpm
C 172,251,255
F 114,212,0
WE ./pics/w4.xpm
SO ./pics/w3.xpm

1111111
100S011
1000001111111
1002000000001
10201111111011
1200101   1021
1111111   1111